R	600 400

NO ./texture/eagle.xpm
SO ./texture/bluestone.xpm
WE ./texture/redbrick.xpm
EA ./texture/greystone.xpm

S ./texture/barrel.xpm


F 255, 0, 0
C 0, 150, 255




1111111111111111111111111
1000000000110000010000201
1011000020110010012000001
1201010000000020000000001111111111
111111020011000001110000002000001
10000121201010S001110111111111111
11110111111111111100000010001
11110111111111011101010010001
11000000110101111100000010001
10002000000020001100000010001
10000000000000001101010010001
11000001010101011111011112001
111011111110101 101110010001
11111111 1111111 111111111111
